the-gene-siddhartha-mukherjee	The Gene - Siddhartha Mukherjee
the-vital-question-nick-lane	The Vital Question - Nick Lane
against-empathy-paul-bloom	Against Empathy - Paul Bloom
on-tyrrany-and-on-ukraine__timothy-snyder	On Tyrrany (and on Ukraine) | Timothy Snyder
desicive__chip-dan-heath	Desicive | Chip & Dan Heath
sexuality-a-very-short-introduction__véronique-mottier	Sexuality: A Very Short Introduction | Véronique Mottier
supercommunicators-charles-duhigg	Supercommunicators - Charles Duhigg
procrastination-fuschia-sirios	Procrastination - Fuschia Sirios
exam-nation-sammy-wight	Exam Nation - Sammy Wight
everything-is-predictable-tom-chivers	Everything is predictable - Tom Chivers
the-anti-ableist-manifesto-tiffany-yu	The anti ableist manifesto - Tiffany Yu
economics-in-2-lessons-john-quiggin	Economics in 2 lessons - John Quiggin
unmasked-ellie-middleton	Unmasked - Ellie Middleton
being-you-anil-seth	Being you - Anil Seth
lazyness-does-not-exist	Lazyness does not exist
attention-span-gloria-mark	Attention span - Gloria Mark
eve-cat-bohannon	Eve - Cat Bohannon
bernullis-fallacy-aubrey-clayton	Bernullis Fallacy - Aubrey Clayton
ritual-dimitris-xygalatas	Ritual - Dimitris Xygalatas
the-book-of-why-judea-pearl	The book of why - Judea Pearl
second-brain-tiago-forte	Second brain - Tiago Forte
economics-for-the-common-good-jean-tirole	Economics for the common good - Jean Tirole
consoomerisn	consoomerisn
deng-xiaping	Deng Xiaping
the-case-against-education-bryan-caplan	The case against education - Bryan Caplan
the-art-of-deception-kevin-mitnick	The art of deception - Kevin Mitnick
humankind-rutger-bregman	Humankind - rutger bregman
